**************************
*           E            *
*                        *
*                        *
*         S              *
**************************