*************
*...........*
*.....E.....*
*...........*
*...........*
*...S.......*
*...........*
*************