*************
*...........*
*.....E.....*
*..B........*
*........B..*
*...S.......*
*..B.....B..*
*************