**************************
*........................*
*...........E............*
*........................*
*........................*
*........................*
*........................*
*.......S................*
*........................*
*........................*
**************************