**************************
*                        *
*           F            *
*                        *
*                        *
*                        *
*                        *
*         S              *
*                        *
*                        *
*                        *
*                        *
*                        *
**************************