***************
*.......E.....*
*.............*
*.............*
*.....S.......*
***************