*******************
*...........E.....*
*.................*
*.................*
*.........S.......*
*******************