*************
*...........*
*.....E.....*
*...........*
*........B..*
*...S.......*
*...........*
*************