**************************
*                        *
*           E            *
*                        *
*                        *
*                        *
*                        *
*         S              *
*                        *
*                        *
*                        *
*                        *
*                        *
**************************